d00mm000mm0mm0m
mm000mm0000000m
000m0000mm0mmmm
mm000m0mm00mm00
000mm000mm0000m
m00m00mmm00mmmm
00mmm00m00mm000
m000mm0m0mm000m
00mm000m000mm0m
0m000mm00m0000m
00m000m0000mm0m
m0mmm00mmm0000m
000m0m0m0mmm00m
0m000mmm00mm0m0
0mmm000mm00000a




